

                            ÐÂ ¶« ·½ ¹Ê ÊÂ ¢ò 
                           
                               -----ºÓº£°æ

                         <================{==0

            @@@@@@@@@@@@@@@@@@@@@@@@@@@@@@@@@@@@@@@@@@@@@@@@@@@@      
            @                                                  @  
            @       Çà   ´º   ¸¶   Ò»   ½£                     @    
            @                                                  @
	    @                      °×   ·¢   ¾¡   Ïà   Ë¼      @  
            @                                                  @
            @@@@@@@@@@@@@Ð¦ °Á ½­ ºþ    Ð¦ °Á ºÓ º£@@@@@@@@@@@@@


                      ************Çë ×¢ Òâ************
             ±¾ÏµÍ³Ä¿Ç°È«Ìì¿ª·Å£¬Çë¸÷Î»Íæ¼Ò¾¡ÐË£¬Î×Ê¦ÃÇ×£ÄãºÃÔË£¡
